	
Araco	Ivana
Athila41	Athila
Bagy1	Tekay
Bagy2	Athila
Batata	Tork
Beetle1	CRM
Calypso	Athila
Cereba	CRM
CRM	CRM
Cyclops2	Athila
Del	Tekay
Diaspora	Athila
Endovir11	SIRE
Fourf	TAR
Galadriel	Galadriel
Gimli	Reina
Gloin	Reina
Hopscotch	Ale
Ifg7	Reina
Koala	Ale
Legolas	Tekay
Melmoth	Ale
Monkey	Galadriel
Opie2	SIRE
Oryco11	Ivana
Oryco12	Ivana
Peabody	Tekay
Poco	Ivana
Reina	Reina
Retrofit	Ale
Retrosat2	Tekay
RTvr2	Tork
SIRE14	SIRE
Sto4	Ikeros
Tma	Tekay
Tnt1	Tork
Tntom1	Galadriel
Tork4	Tork
ToRTL1	SIRE
TSI9	SIRE
Tto1	Tork
V12	Tork
Vitico11	Ivana
Vitico12	Ale
